7
9
WWWWWW...
WLLLLWWWW
W..BWW..W
W.BB....W
WHB.W...W
WW..WWWWW
.WWWW....