7
7
WWWWWWW
W.L.L.W
WLBBBLW
W.BHB.W
WLBBBLW
W.L.L.W
WWWWWWW