8
8
..WWW...
..WLW...
..W.WWWW
WWWB.BLW
WL.BHWWW
WWWWBW..
...WLW..
...WWW..