9
9
......WWW
..WWWWWLW
..W..BLHW
WWW.....W
W..B.WWWW
W....W...
WWB.LW...
.W..WW...
.WWWW....