8
7
.WWWWW.
WW...WW
W.LBL.W
W.BWB.W
W.LBL.W
W....WW
WW.HWW.
.WWWW..