7
8
.WWWWWWW
.W.....W
.W.LBL.W
WW.BHB.W
W..LBL.W
W......W
WWWWWWWW