8
8
..WWWW..
..W.HWWW
..WBB..W
WWW.BL.W
WLLL.WWW
WWWB.W..
..W..W..
..WWWW..