11
22
....WWWWW.............
....W...W.............
....WB..W.............
..WWW..BWWW...........
..W..B..B.W...........
WWW.W.WWW.W.....WWWWWW
W...W.WWW.WWWWWWW..LLW
W.B..B.............LLW
WWWWW.WWWW.WHWWWW..LLW
....W......WWW..WWWWWW
....WWWWWWWW..........