8
8
..WWW...
.WWLW...
.W.BWWWW
WW...BHW
WL.BBLWW
WWWW.WW.
...WLW..
...WWW..