5
5
WWWWW
WH..W
W.B.W
W.L.W
WWWWW